1111011111
1000000001
1011101101
1110000101
1000111101
1110001001
1011101111
1000001101
1101100001
1111111011
