10101
10001
10111
10001
10101
11101
